{
  "á": "a",
  "Á": "A",
  "à": "a",
  "À": "A",
  "ă": "a",
  "Ă": "A",
  "â": "a",
  "Â": "A",
  "å": "a",
  "Å": "A",
  "ä": "ae",
  "Ä": "Ae",
  "ã": "a",
  "Ã": "A",
  "ą": "a",
  "Ą": "A",
  "ā": "a",
  "Ā": "A",
  "ć": "c",
  "Ć": "C",
  "ĉ": "c",
  "Ĉ": "C",
  "č": "c",
  "Č": "C",
  "Ċ": "C",
  "ç": "c",
  "Ç": "C",
  "ď": "d",
  "Ď": "D",
  "đ": "d",
  "Đ": "D",
  "ĕ": "e",
  "Ĕ": "E",
  "ě": "e",
  "Ě": "E",
  "ė": "e",
  "Ė": "E",
  "ę": "e",
  "Ę": "E",
  "ē": "e",
  "Ē": "E",
  "ğ": "g",
  "Ğ": "G",
  "ĝ": "g",
  "Ĝ": "G",
  "ġ": "g",
  "Ġ": "G",
  "ģ": "g",
  "Ģ": "G",
  "ĥ": "h",
  "Ĥ": "H",
  "ħ": "h",
  "Ħ": "H",
  "í": "i",
  "Í": "I",
  "ì": "i",
  "Ì": "I",
  "ĭ": "i",
  "Ĭ": "I",
  "î": "i",
  "Î": "I",
  "ï": "i",
  "Ï": "I",
  "ĩ": "i",
  "Ĩ": "I",
  "İ": "I",
  "į": "i",
  "Į": "I",
  "ī": "i",
  "Ī": "I",
  "ĵ": "j",
  "Ĵ": "J",
  "ķ": "k",
  "Ķ": "K",
  "ĺ": "l",
  "Ĺ": "L",
  "ľ": "l",
  "Ľ": "L",
  "ļ": "l",
  "Ļ": "L",
  "ł": "l",
  "Ł": "L",
  "ŀ": "l",
  "Ŀ": "L",
  "ń": "n",
  "Ń": "N",
  "ň": "n",
  "Ň": "N",
  "ñ": "n",
  "Ñ": "N",
  "ņ": "n",
  "Ņ": "N",
  "ó": "o",
  "Ó": "O",
  "ò": "o",
  "Ò": "O",
  "ŏ": "o",
  "Ŏ": "O",
  "ô": "o",
  "Ô": "O",
  "ö": "oe",
  "Ö": "Oe",
  "Ő": "O",
  "õ": "o",
  "Õ": "O",
  "ø": "o",
  "Ø": "O",
  "ō": "o",
  "Ō": "O",
  "ŕ": "r",
  "Ŕ": "R",
  "ŗ": "r",
  "Ŗ": "R",
  "ś": "s",
  "Ś": "S",
  "ŝ": "s",
  "Ŝ": "S",
  "š": "s",
  "Š": "S",
  "ş": "s",
  "Ş": "S",
  "ſ": "s",
  "ť": "t",
  "Ť": "T",
  "ţ": "t",
  "Ţ": "T",
  "ŧ": "t",
  "Ŧ": "T",
  "ú": "u",
  "Ú": "O",
  "ù": "u",
  "Ù": "O",
  "ŭ": "u",
  "Ŭ": "U",
  "û": "u",
  "Û": "O",
  "ů": "u",
  "Ů": "U",
  "ü": "ue",
  "Ü": "Ue",
  "ű": "u",
  "Ű": "U",
  "ũ": "u",
  "Ũ": "U",
  "ų": "u",
  "Ų": "U",
  "ū": "u",
  "Ū": "U",
  "ŵ": "w",
  "Ŵ": "W",
  "ý": "y",
  "Ý": "Y",
  "ŷ": "y",
  "Ŷ": "Y",
  "ÿ": "y",
  "Ÿ": "Y",
  "ź": "z",
  "Ź": "Z",
  "ž": "z",
  "Ž": "Z",
  "ż": "z",
  "Ż": "Z"
}
