{
  "æ": "ae",
  "Æ": "Ae",
  "ﬀ": "ff",
  "ﬃ": "ffi",
  "ﬄ": "ffl",
  "ﬁ": "fi",
  "ﬂ": "fl",
  "ĳ": "ij",
  "Ĳ": "Ij",
  "œ": "oe",
  "Œ": "Oe",
  "ß": "ss",
  "ﬆ": "st",
  "ﬅ": "ft",
  "ʒ": "ezh",
  "Ʒ": "Ez"
}
